#########################
# P      $#             #  
######   #     #      # #  
#    #       ###      # #  
#   $#  @    #        # # 
### ## #### ######## ####
#    #   #    ###  #  @ #  
# @  #   #    #    #  # # 
### ## #### ###### ######
#    #       ###    @ # #  
#    #  @    # @      # # 
#    #  $    ###      # #  
#$     ####       @   # #  
#########################