#########################
# P       #             #  
######   #     #      # #  
#    #       ###      # #  
#    #  @    #        # # 
### ## #### ######## ####
#    #   #    ###  #  @ #  
# @  #   #    #    #  # # 
### ## #### ###### ######
#    #       ###    @ # #  
#    #  @    # @      # # 
#    #       ###      # #  
#    # ####       @   # #  
#########################